###########################################
# #   #   #       #       #   #   #   #   #
# # ##### # ### ### ### ### ### ##### ### #
# # # #     #         # #     #         # #
# # # # ### # ####### ##### # # ### ### # #
# #       # # # #       # # # # #   #     #
# # ### ##### # # ### ### # ### ### #######
# # #     #   #   # # #     #   # # #     #
# # ### ######### # ### # ##### # # ### # #
# #   #   #   # #     # #   #   # #     # #
# # ######### # ### # ##### ##### # # # # #
#       #     #     # # #       #   # # # #
# ### ##### ######### # # ### # # # ### # #
# #       # #   # #       #   # # # #   # #
### ####### # ### ####### ####### ##### ###
#     # #   #       # #   # # # # #   # # #
# # ### # ### ### # # ### # # # # # ### # #
# #   #     #   # # #   #   # # # #       #
### # # # ### ##### # ##### # # ### ##### #
#   # # #         # #   # # #   #   #     #
### ### ##### # ##### # # # # # # ####### #
#     #     # # # #   # #     # #     # # #
# ### ######### # ##### ### ##### # ### # #
# #   #     #   #   #   # # # #   # # #   #
### ### ### # ### # ### # ### # ##### # ###
#   #     # #   # #   # #     #     # #   #
# ### ####### ### # ### # ### # # # # ### #
# #   #       #   # #   # #   # # # #     #
# # # # ##### # ##### # # ####### ### #####
#   # #   # #         #     #     # #   # #
# # ####### # ##### ##### # ### # # ### # #
# # #             #   #   #   # # # # # # #
### # # ### ########### # ####### # # ### #
# #   #   # #     # #   #     # #     #   #
# ### ######### # # # ### ##### ### ##### #
#     #     #   # #     #     #           #
########### # ####### ### ##### ### # #####
#         #     #       #     # #   #   # #
### ### ##### ### # # ####### ####### # # #
#   #     #     # # #       #       # #   #
# ##### ####### ### ############# # # ### #
#     #                 #         #   #   #
###########################################
